111100001111100001111
152200004444400002251
100004403333304400001
122023300020003320221
100000000000000000001
121000200242002000121
100000000030000000001
144444005040500444441
133333000030000333331
122222022040220222221
102220000030000022201
100200000505000002001
100004440000044400001
100003330020033300001
100000000000000000001
100000000000000000001
140000000050000000041
131150005000500051131
111110000000000011111

