111112222222222211111
122223334444433322221
276760001444100067672
267000000111000000762
270009900010009900072
200098890000098890002
200985589000985589002
200854458909854458002
200510015898510015002
200500000585000005002
200590000050000095002
200089511555115980002
200008915444519800002
230000895555598000032
263000089000980000372
136300008595800003731
133630000080000037331
133322000000000223331
111122222222222221111