211111112222211111112
122223334444433322221
166700007444700007661
167000000747000000761
170009900070009900071
100098890000098890001
100985589000985589001
200854458909854458002
200570075898570075002
200500000585000005002
200590000050000095002
200089577555775980002
100008975444579800001
130000895555598000031
163000089050980000361
136300008595800003631
133630000080000036331
133363000000000363331
211111112222211111112